        ########
        # 12   #
        # $#$ ##
        # $  $#
        ##$ $ #
######### $ # ###
#....  ## $  $  #
##...    $  $   #
#....  ##########
########


