  ####
  #  ###########
  #    $   $ $ #
  # $# $ #  $  #
  #  $ $  #    #
### $# #  #### #
#1#$ $ $  ##   #
#2   $ #$#   # #
#   $    $ $ $ #
#####  #########
  #      #
  #      #
  #......#
  #......#
  #......#
  ########


