######## 
#  12  #
#      #
#$$$$$$#
#......#
#      #
########

