          #######
          #  ...#
      #####  ...#
      #      . .#
      #  ##  ...#
      ## ##  ...#
     ### ########
     # $$$ ##
######  $ $ #####
#12  #$ $   #   #
#  $  $    $  $ #
###### $$ $ #####
     #      #
     ########


