    #####
    #   #
    #$  #
  ###  $##
  #  $ $ #
### # ## #   ######
#   # ## #####  ..#
# $  $         1..#
##### ### # ## 2..#
    #     #########
    #######

