       #####
 #######   ##
## 1  ## $$ #
#    $      #
#  $  ###   #
### #####$###
# $  ### ..#
# $ $ $ ...#
#    ###...#
# $$ # #...#
#  ### #####
####


