############
#..  #     ###
#..  # $  $  #
#..1 #$####  #
#..      ##  #
#..  # #  $ ##
###### ##$ $ #
  # $  $ $ $ #
  #    #     #
  ############


