###### #####
#..  # #1  #
#..  ###   #
#..     $$ #
#..  # # $ #
#..### # $ #
#### $ #$  #
   #  $# $ #
   # $  $  #
   #  ##   #
   #########


