########
#  1   #
#      #
#$$$$$$#
#......#
#      #
########

