        #####
        #   #####
        # #$##  #
        #     $ #
######### ###   #
#....  ## $  $###
#....    $ $$ ##
#....  ##$  $ 1#
#########  $   #
        # $ $  #
        ### ## #
          #    #
          ######


