           ########
           #  ....#
############  ....#
#    #  $ $   ....#
# $$$#$  $ #  ....#
#  $     $ #  ....#
# $$ #$ $ $########
#  $ #     #
## #########
#    #     #
#     $   1#
#  $$#$$   #
#    #     #
###########


